wl wl wl wl wl wl wl wl wl wl wl wl wl wl wl wl wl wl wl wl wl wl wl wl gs gs gs gs gs wl 
wl ws gb gb dt dt dt gb gb gb gb gb gb gb gb gb gb gb gb gb gb gb gb gb gs gs gs gs gs wl 
wl ws gb gb dt dt dt gb gb gb gb gb gb gb gb gb gb gb gb gb gb gb gb gb gs gs gs gs gs wl 
wl ws gb gb dt dt dt gb gb ws ws ws ws ws ws ws ws ws ws ws ws ws gb gb gs gs gs gs gs wl 
wl ws gb gb dt dt dt gb gb wr wr wr wr wr wr wr wr wr wr wr wr wr gb gb gs gs gs gs gs wl 
wl ws gb gb dt dt dt gb gb wr wr wr wr wr wr wr wr wr wr wr wr wr gb gb gs gs gs gs gs wl 
wl ws gb gb dt dt dt gb gb wr wr wr wr wr wr wr wr wr wr wr wr wr gb gb gs gs gs gs gs wl 
wl ws gb gb dt dt dt gb gb wr wr wr wr wr wr wr wr wr wr wr wr wr gb gb gs gs gs gs gs wl 
wl ws gb gb dt dt dt gb gb wl wl wl wl wl wl wl wl wl wl wl wl wl gb gb gs gs gs gs gs wl 
wl ws gb gb dt dt dt gb gb wl pc pc pc pc pc pc pc pc pc pc pc wl gb gb gs gs gs gs gs wl 
wl ws gb gb dt dt dt gb gb wl pf pf pf pf pf pf pf pf pf pf pf wl gb gb gs gs gs gs gs wl 
wl ws gb gb dt dt dt gb gb wl pf pf pf pf pf pf pf pf pf pf pf wl gb gb gs gs gs gs gs wl 
wl ws gb gb dt dt dt gb gb pf pf pf pf pf pf pf pf pf pf pf pf wl gb gb gs gs gs gs gs wl 
wl ws gb gb dt dt dt gb gb pf pf pf pf pf pf pf pf pf pf pf pf wl gb gb gs gs gs gs gs wl 
wl ws gb gb dt dt dt gb gb pf pf pf pf pf pf pf pf pf pf pf pf wl gb gb gs gs gs gs gs wl 
wl ws gb gb dt dt dt gb gb pf pf pf pf pf pf pf pf pf pf pf pf wl gb gb gs gs gs gs gs wl 
wl ws gb gb dt dt dt gb gb wl pf pf pf pf pf pf pf pf pf pf pf wl gb gb gs gs gs gs gs wl 
wl ws gb gb gb gb gb gb gb wl pf pf pf pf pf pf pf pf pf pf pf wl gb gb gs gs gs gs gs wl 
wl ws gb gb gb gb gb gb gb wl pc pc pc pc pc pc pc pc pc pc pc wl gb gb gs gs gs gs gs wl 
wl wl wl wl wl wl wl wl wl wl wl wl wl wl wl wl wl wl wl wl wl wl gb gb gs gs gs gs gs wl
