wl wl wl wl wl wl wl wl wl wl wl wl wl gs gs gs gs wl wl wl wl wl wl wl wl wl wl wl wl wl
wl gs gs gs gs gs gs gs gs gs gs gs gs gs gs gs gs gs gs gs gs gs gs gs gs gs gs gs gs wl
wl gs gs gs gs gs gs gs gs gs gs gs gs gs gs gs gs gs gs gs gs gs gs gs gs gs gs gs gs wl
wl gs gs gs gs gs gs gs gs gs gs gs gs gs gs gs gs gs gs gs gs gs gs gs gs gs gs gs gs wl
wl gs gs wl wl wl wl wl wl wl wl wl wl wl wl wl wl wl wl wl wl wl wl wl wl wl wl gs gs wl
wl gb gb gb gb gb gb gb gb gb gb gb gb gb gb gb gb gb gb gb gb gb gb gb gb gb gb gb gb wl
wl gb gb gb gb gb gb gb gb gb gb gb gb gb gb gb gb gb gb gb gb gb gb gb gb gb gb gb gb wl
wl dt dt dt dt dt dt dt dt dt dt dt dt dt dt dt dt dt dt dt dt dt dt dt dt dt dt dt dt wl
wl dt dt dt dt dt dt dt dt dt dt dt dt dt dt dt dt dt dt wl wl wl wl wl wl wl wl wl wl wl
wl f1 pc f1 pc f1 pc f1 pc f1 pc dt dt dt dt dt dt dt dt pf pf pf pf pf pf pf pf pf pf wl
wl f1 pc f1 pc f1 pc f1 pc f1 pc dt dt dt dt dt dt dt dt pf pf pf pf pf pf pf pf pf pf wl
wl dt dt dt dt dt dt dt dt dt dt dt dt dt dt dt dt dt dt wl wl wl wl wl wl wl wl wl wl wl
wl dt dt dt dt dt dt dt dt dt dt dt dt dt dt dt dt dt dt dt dt dt dt dt dt dt dt dt dt wl
wl gb gb gb gb gb gb gb gb gb gb gb gb gb gb gb gb gb gb gb gb gb gb gb gb gb gb gb gb wl
wl gb gb gb gb gb gb gb gb gb gb gb gb gb gb gb gb gb gb gb gb gb gb gb gb gb gb gb gb wl
wl gs gs wl wl wl wl wl wl wl wl wl wl wl wl wl wl wl wl wl wl wl wl wl wl wl wl wl wl wl
wl gs gs gs gs gs gs gs gs gs gs gs gs gs gs gs gs gs gs gs gs gs gs gs gs gs gs gs gs wl
wl gs gs gs gs gs gs gs gs gs gs gs gs gs gs gs gs gs gs gs gs gs gs gs gs gs gs gs gs wl
wl gs gs gs gs gs gs gs gs gs gs gs gs gs gs gs gs gs gs gs gs gs gs gs gs gs gs gs gs wl
wl wl wl wl wl wl wl wl wl wl wl wl wl wl wl wl wl wl wl wl wl wl wl wl gs gs gs gs gs wl
