wl wl wl wl wl wl wl wl wl wl wl wl wl wl wl wl wl wl wl wl wl wl wl wl gs gs gs gs gs wl 
wl ws cs cs dt dt dt cs cs cs cs cs cs cs cs cs cs cs cs cs cs cs cs cs gs gs gs gs gs wl 
wl ws cs cs dt dt dt cs cs cs cs cs cs cs cs cs cs cs cs cs cs cs cs cs gs gs gs gs gs wl 
wl ws cs cs dt dt dt cs cs ws ws ws ws ws ws ws ws ws ws ws ws ws cs cs gs gs gs gs gs wl 
wl ws cs cs dt dt dt cs cs wr wr wr wr wr wr wr wr wr wr wr wr wr cs cs gs gs gs gs gs wl 
wl ws cs cs dt dt dt cs cs wr wr wr wr wr wr wr wr wr wr wr wr wr cs cs gs gs gs gs gs wl 
wl ws cs cs dt dt dt cs cs wr wr wr wr wr wr wr wr wr wr wr wr wr cs cs gs gs gs gs gs wl 
wl ws cs cs dt dt dt cs cs wr wr wr wr wr wr wr wr wr wr wr wr wr cs cs gs gs gs gs gs wl 
wl ws cs cs dt dt dt cs cs wl wl wl wl wl wl wl wl wl wl wl wl wl cs cs gs gs gs gs gs wl 
wl ws cs cs dt dt dt cs cs wl pc pc pc pc pc pc pc pc pc pc pc wl cs cs gs gs gs gs gs wl 
wl ws cs cs dt dt dt cs cs wl pf pf pf pf pf pf pf pf pf pf pf wl cs cs gs gs gs gs gs wl 
wl ws cs cs dt dt dt cs cs wl pf pf pf pf pf pf pf pf pf pf pf wl cs cs gs gs gs gs gs wl 
wl ws cs cs dt dt dt cs cs pf pf pf pf pf pf pf pf pf pf pf pf wl cs cs gs gs gs gs gs wl 
wl ws cs cs dt dt dt cs cs pf pf pf pf pf pf pf pf pf pf pf pf wl cs cs gs gs gs gs gs wl 
wl ws cs cs dt dt dt cs cs pf pf pf pf pf pf pf pf pf pf pf pf wl cs cs gs gs gs gs gs wl 
wl ws cs cs dt dt dt cs cs pf pf pf pf pf pf pf pf pf pf pf pf wl cs cs gs gs gs gs gs wl 
wl ws cs cs dt dt dt cs cs wl pf pf pf pf pf pf pf pf pf pf pf wl cs cs gs gs gs gs gs wl 
wl ws cs cs cs cs cs cs cs wl pf pf pf pf pf pf pf pf pf pf pf wl cs cs gs gs gs gs gs wl 
wl ws cs cs cs cs cs cs cs wl pc pc pc pc pc pc pc pc pc pc pc wl cs cs gs gs gs gs gs wl 
wl wl wl wl wl wl wl wl wl wl wl wl wl wl wl wl wl wl wl wl wl wl cs cs gs gs gs gs gs wl
